000000000000000000000000000000000000000000000
000000000000000000000000000000000000000000000
000000000000000000000000000000000000000000000
000000000000000000000000000000000000000000000
000000000000000000000000000000000000000000000
000000000000000000000000000000000000000003333
000000000000000000000000000000000000003333333
000000000000000000000000000000000000033222223
000000000000000000000000000000000000043333333
000000000000000000000000000000004555542222223
000000000000000000000000000000334555542222223
000000000000000000000000000333324444442333333
000000000000000000000000033322222222223333333
000000000000000000000000332222222222222222333
000000000000000000000000333322222222222223333
000000000000000000000003322222222222222222223
000000000000000000000333222222222222222222223
000000000000000000333333333333333333333333333
000000000000000033222222222222222222222222223
000000000000003332222222222222222223322222223
000000000000033332222222222222222233332222223
000000000000033332222222222222222222222233333
111111111111144444444444444444444444444444444
444444444444444444444444444444444444444444444